行動を代わっ	に	人間に
判断をする	を	推論判断を 画像データを
処理を用い記述をする	と	主体と
注目を集め	が	サポートベクターマシンが
経験を行う学習を行う	に	元に
流行を超え	て に	超えて 社会に
学習を繰り返す	と を	基本と 学習を ことを
学習をする	て で に は を を通して	生成規則を通して 元に ACT-Rでは 推論ルールを 統計的学習を
進化を見せ	て において は	加えて 生成技術において 敵対的生成ネットワークは
進化をいる	て において は	加えて 生成技術において 敵対的生成ネットワークは
生成を行っ生成をいく	て も	応用も
開発を行っ	は	エイダ・ラブレスは
テストをする	として は を	アランチューリングは テストを チューリングテストを
処理を行わ処理をせる	が	提唱されたが 試みが
処理を行わ	に により	同年に Webに
処理をせる	に により	同年に Webに
意味をし	に	データに
処理を行わ	て に	付加して コンピュータに
処理をせる	て に	付加して コンピュータに
研究を進める	て	費やして
命令をし	で	機構で
運転をする	に	元に
特許をし	が に まで	日本が 2018年までに
特許をいる	が に まで	日本が 2018年までに
研究をし	に	1日に 発売に
運転をする	て に	基づいて 柔軟に
注目を集め	から は	ファジィは
制御をし	を	ニューロファジィ制御を 限界を
成功を受け制御を用いる	て も	受けて 他社も
制御をする	から	
制御をする	が に は	白物家電が 大多数に 末には
進歩を担い	を	進歩を 世界を
改善を果たし	が で に	チームが 画像処理コンテストで 2012年に
プログラムを使い	が に	受験生が 実際に
研究を続け	が て	ジェフホーキンスが 向けて
研究をいる	が て	ジェフホーキンスが 向けて
)をし	に は	8月には
注目を集め	に	急速に
普及を受け	を	普及を AGIを
学習を組み合わせる	て で と は	有望と 現場では
投資を行っ	で に	民間企業主導で 全世界的に
探索を行う	で	無報酬で
推論をし	て	経て
研究を始め	とも は	Googleは
研究をおり	とも は	Googleは
研究を行っ	て	
研究をいる	て	
開発をし	で は	官民一体で 中国では
開発をてる	で は	官民一体で 中国では
実験をし	て で に は	比較して 環境に 中国では
開発をし	で	日本で
開発をいる	で	日本で
投資をする	に は まで	2022年までに 韓国は
学習をする	が と	数学知識が 必要と
シミュレーションを行う	に は も	行うには 知識も
反乱を起こす	て に対して	於いて 人間に対して
弾圧を併せ持つ	が で	中華人民共和国が 開発競争で
監視を行わ	に まで	人工知能に
監視をせ	に まで	人工知能に
手続きを経	を	ウイグル族を 法的手続きを
差別を認め	から が で は	EU一般データ保護規則が 欧州連合では
研究をし	が で と に は	マサチューセッツ工科大学が 精度で Amazonと 論争に Megviiは 際は
展開を変え戦争をさ戦争をせ	を	展開を 戦争を 軍事バランスを
制御をし	は	AIプログラムは
制御をおり	は	AIプログラムは
判断を介さ	から	
禁止を求め	が に は	ヒューマン・ライツ・ウォッチが 4月には
禁止をいる	が に は	ヒューマン・ライツ・ウォッチが 4月には
運用をめぐる	を	運用を 国際ルールを
競争を行っ	は をめぐって	米国中国ロシアは
競争をいる	は をめぐって	米国中国ロシアは
記録をし	を	記録を 都市を
試験を行う	と	スウォームと
追及を受け	て で と とともに は	整合性で 拒否すると 公聴会では
研究をし	が	Microsoftが
解任をし	て は	Google社員らは
解散をし	が で は	倫理委員会が 理由で Googleは
存在を見いだす	に	ものに
)」をし)」をいる	に	AIに
実現をし	を を通して	実現を 社会を
話をし	は	哲学者は
話をいる	は	哲学者は
疎通を行う	て は も	ことは 使っても
勘違いをし	が について	高かったが
議論を行っ	まで	
議論をき	まで	
