行動を代わっ	に を	人間に 知的行動を
判断をする	を	推論判断を
処理を用い	を	記号処理を
記述をする	と を	主体と 記述を
注目を集め	が を	サポートベクターマシンが 注目を
経験を行う学習を行う	に を	元に 経験を 学習を
流行を超え	を	流行を
学習を繰り返す	を	学習を
学習をする	て で に は を を通して	なされている 生成規則を通して ACT-Rでは 元に 推論ルールを 統計的学習を
進化を見せ	て において は を	活躍している 加えて 生成技術において 敵対的生成ネットワークは 進化を
進化をいる	て において は を	活躍している 加えて 生成技術において 敵対的生成ネットワークは 進化を
生成を行っ	を	コンテンツ生成を
生成をいく	を	コンテンツ生成を
開発を行っ	は を	エイダ・ラブレスは 開発を
テストをする	を	テストを
処理を行わ	を	処理を
処理をせる	を	処理を
処理を行わ	に により を	同年に ティム・バーナーズリーにより Webに 知的処理を
処理をせる	に により を	同年に ティム・バーナーズリーにより Webに 知的処理を
意味をし	に を	データに 意味を
処理を行わ	て に を	付加して コンピュータに 知的処理を
処理をせる	て に を	付加して コンピュータに 知的処理を
研究を進める	て を	費やして 研究を
命令をし	で を	機構で 命令を
運転をする	に を	元に 運転を
特許をし	が に まで を	日本が 2018年までに 特許を
特許をいる	が に まで を	日本が 2018年までに 特許を
研究をし	を	研究を
運転をする	て に を	基づいて 柔軟に 運転を
注目を集め	から は を	ことから ファジィは 注目を
制御をし	を	ニューロファジィ制御を
成功を受け	を	成功を
制御を用いる	て も を	受けて 他社も 知的制御を
制御をする	から を	少なさから 制御を
制御をする	を	知的制御を
進歩を担い	を	進歩を
改善を果たし	が で に を	チームが 画像処理コンテストで 2012年に 精度改善を
プログラムを使い	を	専用プログラムを
研究を続け	が て を	ジェフホーキンスが 向けて 研究を
研究をいる	が て を	ジェフホーキンスが 向けて 研究を
)をし	に は を	8月には 記号接地問題(シンボルグラウンディング問題)を
注目を集め	に を	急速に 注目を
普及を受け	を	普及を
学習を組み合わせる	を	機械学習を
投資を行っ	で に を	民間企業主導で 全世界的に 投資を
探索を行う	で を	無報酬で 探索を
推論をし	て を	経て 推論を
研究を始め	とも は を	マックスプランク研究所とも Googleは 共同研究を
研究をおり	とも は を	マックスプランク研究所とも Googleは 共同研究を
研究を行っ	て を	始めており 研究を
研究をいる	て を	始めており 研究を
開発をし	で は を	中国では 官民一体で 研究開発を
開発をてる	で は を	中国では 官民一体で 研究開発を
実験をし	を	実験を
開発をし	で を	日本で 研究開発を
開発をいる	で を	日本で 研究開発を
投資をする	に は まで を	2022年までに 韓国は 投資を
学習をする	を	深層学習を
シミュレーションを行う	を	脳シミュレーションを
反乱を起こす	て に対して を	於いて 人間に対して 反乱を
弾圧を併せ持つ	を	弾圧を
監視を行わ	に まで を	人工知能に 歩行者まで 監視を
監視をせ	に まで を	人工知能に 歩行者まで 監視を
手続きを経	を	ウイグル族を 法的手続きを
差別を認め	を	差別を
研究をし	を	研究を
展開を変え	を	展開を
戦争をさ	を	戦争を
戦争をせ	を	戦争を
制御をし	は を	AIプログラムは ファジィ制御を
制御をおり	は を	AIプログラムは ファジィ制御を
判断を介さ	から を	観点から 判断を
禁止を求め	が に は を	ヒューマン・ライツ・ウォッチが 4月には 禁止を
禁止をいる	が に は を	ヒューマン・ライツ・ウォッチが 4月には 禁止を
運用をめぐる	を	運用を
競争を行っ	は を をめぐって	米国中国ロシアは 開発競争を 軍事利用をめぐって
競争をいる	は を をめぐって	米国中国ロシアは 開発競争を 軍事利用をめぐって
記録をし	を	記録を
試験を行う	を	試験を
追及を受け	て で と とともに は を	暴露されており 公聴会では 整合性で とともに 拒否すると 追及を
研究をし	が を	Microsoftが 共同研究を
解任をし	て は を	含まれており Google社員らは 解任を
解散をし	が で は を	倫理委員会が 理由で Googleは 解散を
存在を見いだす	に を	ものに 霊的存在を
)」をし	を	道)」を
)」をいる	を	道)」を
実現をし	を	実現を
話をし	は を	哲学者は 話を
話をいる	は を	哲学者は 話を
疎通を行う	を	意思疎通を
勘違いをし	を	勘違いを
議論を行っ	まで を	これまで 議論を
議論をき	まで を	これまで 議論を
